Abbott - Costello
Adam - Eve
an arm - a leg
Antony - Cleopatra
apples - oranges
bacon - eggs
Barbie - Ken
Batman - Robin
bed - breakfast
before - after
Bert - Ernie
big - small
big - tall
black - white
Bonnie - Clyde
bow - arrow
boys - girls
bread - butter
Cain - Abel
Castor - Pollux
cold - hot
Crick - Watson
cut - paste
day - night
death - taxes
Dick - Jane
divide - conquer
dogs - cats
each - every
ebony - ivory
fast - slow
fat - thin
fife - drum
fire - brimstone
fish - chips
flotsam - jetsam
free - clear
Gilbert - Sullivan
give - take
good - bad
good - evil
Hansel - Gretel
happy - sad
heaven - earth
heaven - hell
high - low
Hiroshima - Nagasaki
hot - cold
in - out
Jack - Jill
Jekyll - Hyde
king - queen
Kirk - Spock
ladies - gentlemen
Lady - the Tramp
Lancelot - Guinevere
Laurel - Hardy
left - right
Lewis - Clark
love - hate
Lucy - Desi
mad dogs - Englishmen
Marx - Engels
meat - potatoes
Michelson - Morley
mom - pop
motherhood - apple pie
Napoleon - Josephine
near - far
new - old
old - young
open - shut
Orpheus - Eurydice
Phobos - Deimos
Porgy - Bess
Punch - Judy
push - pull
question - answer
Republicans - Democrats
right - left
right - wrong
rock - a hard place
rock - roll
Romeo - Juliet
Romulus - Remus
salt - pepper
Simon - Garfunkel
skull - bones
smoke - mirrors
stars - stripes
sweet - sour
Tarzan - Jane
the Iliad - the Odyssey
the Owl - the Pussycat
thunder - lightning
Tom - Jerry
Trinidad - Tobago
Tristan - Isolde
Tweedledum - Tweedledee
ulna - radius
up - down
Venus - Mars
war - peace
Watson - Crick
xylem - phloem
yin - yang
young - old
zeroes - ones